name Dummy Map
win 301
####################################################
#..................................................#
#..................................................#
#..................................................#
#..................................................#
#.EGGG.............................................#
####################################################
